{
  "STAGE": [
    {
      "level": 1,
      "stage": [
        [14, 15, 15, 15, 15, 15, 15, 15, 15, 15, 14],
        [15, 17, 0, 0, 11, 11, 11, 0, 0, 16, 15],
        [15, 0, 0, 0, 11, 11, 11, 0, 0, 0, 15],
        [14, 0, 21, 0, 0, 0, 0, 0, 21, 0, 14],
        [15, 0, 13, 0, 15, 1, 15, 0, 13, 0, 15],
        [15, 2, 13, 0, 0, 12, 0, 0, 13, 2, 15],
        [15, 0, 13, 0, 15, 0, 15, 0, 13, 0, 15],
        [14, 0, 22, 0, 0, 0, 0, 0, 23, 0, 14],
        [15, 0, 0, 0, 11, 11, 11, 0, 0, 0, 15],
        [15, 16, 0, 0, 11, 11, 11, 0, 0, 17, 15],
        [14, 15, 15, 15, 15, 15, 15, 15, 15, 15, 14]
      ]
    },
    {
      "level": 2,
      "stage": [
        [14, 15, 15, 15, 15, 15, 15, 15, 15, 15, 14],
        [15, 17, 0, 0, 11, 11, 11, 0, 0, 16, 15],
        [15, 0, 0, 0, 11, 11, 11, 0, 0, 0, 15],
        [14, 0, 21, 0, 0, 0, 0, 20, 21, 0, 14],
        [15, 0, 13, 0, 0, 1, 0, 0, 13, 0, 15],
        [15, 0, 13, 0, 0, 12, 0, 0, 13, 0, 15],
        [15, 0, 13, 0, 0, 0, 0, 0, 13, 0, 15],
        [14, 0, 21, 19, 0, 0, 0, 0, 21, 0, 14],
        [15, 0, 0, 0, 11, 11, 11, 0, 0, 0, 15],
        [15, 16, 0, 0, 11, 11, 11, 0, 0, 17, 15],
        [14, 15, 15, 15, 15, 15, 15, 15, 15, 15, 14]
      ]
    },
    {
      "level": 3,
      "stage": [
        [23, 15, 15, 15, 15, 15, 15, 15, 15, 15, 23],
        [15, 2, 0, 0, 0, 0, 0, 0, 0, 2, 15],
        [15, 0, 15, 7, 15, 11, 15, 7, 15, 0, 15],
        [15, 0, 21, 0, 8, 0, 0, 0, 21, 0, 15],
        [15, 0, 15, 0, 15, 0, 15, 0, 15, 0, 15],
        [15, 0, 0, 0, 0, 1, 0, 0, 0, 0, 15],
        [15, 0, 15, 0, 15, 0, 15, 0, 15, 0, 15],
        [15, 0, 22, 0, 9, 0, 8, 0, 23, 0, 15],
        [23, 0, 15, 0, 15, 0, 15, 0, 15, 0, 23],
        [23, 15, 15, 15, 15, 15, 15, 15, 15, 15, 23]
      ]
    },
    {
      "level": 4,
      "stage": [
        [10, 15, 15, 15, 21, 15, 15, 15, 15, 15, 10],
        [15, 2, 0, 0, 0, 0, 0, 0, 0, 2, 15],
        [15, 0, 15, 7, 15, 11, 15, 7, 15, 0, 15],
        [15, 0, 21, 0, 8, 0, 0, 0, 21, 0, 15],
        [15, 0, 15, 0, 15, 0, 15, 0, 15, 0, 15],
        [15, 0, 0, 0, 0, 1, 0, 0, 0, 0, 15],
        [15, 0, 15, 0, 22, 0, 9, 0, 15, 0, 15],
        [15, 0, 22, 0, 9, 0, 8, 0, 23, 0, 15],
        [10, 0, 15, 0, 15, 0, 15, 0, 15, 0, 10],
        [10, 15, 15, 15, 15, 15, 15, 15, 15, 15, 10]
      ]
    },
    {
      "level": 5,
      "stage": [
        [9, 15, 15, 15, 15, 15, 15, 15, 15, 15, 9],
        [15, 2, 0, 0, 0, 0, 0, 0, 0, 2, 15],
        [15, 0, 15, 7, 15, 11, 15, 7, 15, 0, 15],
        [15, 0, 21, 0, 8, 0, 0, 0, 21, 0, 15],
        [15, 0, 15, 0, 15, 0, 15, 0, 15, 0, 15],
        [15, 0, 0, 0, 23, 0, 10, 0, 0, 0, 15],
        [15, 0, 15, 0, 22, 0, 9, 0, 15, 0, 15],
        [15, 0, 22, 0, 9, 0, 8, 0, 23, 0, 15],
        [9, 0, 15, 0, 15, 0, 15, 0, 15, 0, 9],
        [9, 15, 15, 15, 15, 15, 15, 15, 15, 15, 9]
      ]
    },
    {
      "level": 6,
      "stage": [
        [9, 15, 15, 15, 15, 15, 15, 15, 15, 15, 9],
        [15, 2, 0, 0, 15, 1, 15, 0, 0, 2, 15],
        [15, 0, 15, 7, 15, 0, 15, 7, 15, 0, 15],
        [15, 0, 21, 0, 15, 0, 15, 0, 21, 0, 15],
        [15, 0, 15, 0, 15, 0, 15, 0, 15, 0, 15],
        [15, 0, 0, 0, 15, 0, 15, 0, 0, 0, 15],
        [15, 0, 15, 0, 15, 0, 15, 0, 15, 0, 15],
        [15, 0, 22, 0, 15, 0, 15, 0, 23, 0, 15],
        [9, 0, 15, 0, 15, 2, 15, 0, 15, 0, 9],
        [9, 15, 15, 15, 15, 15, 15, 15, 15, 15, 9]
      ]
    }
  ]
}
