{
  "STAGE": [
    {
      "level": 1,
      "stage": [
        [2, 2, 2, 2, 2, 2, 2, 2, 2, 2, 2],
        [2, 3, 0, 0, 0, 0, 0, 0, 0, 3, 2],
        [2, 0, 2, 0, 2, 0, 2, 0, 2, 0, 2],
        [2, 0, 4, 0, 0, 0, 0, 0, 4, 0, 2],
        [2, 0, 2, 0, 2, 0, 2, 0, 2, 0, 2],
        [2, 0, 0, 0, 0, 1, 0, 0, 0, 0, 2],
        [2, 0, 2, 0, 2, 0, 2, 0, 2, 0, 2],
        [2, 0, 5, 0, 0, 0, 0, 0, 6, 0, 2],
        [2, 0, 2, 0, 2, 0, 2, 0, 2, 0, 2],
        [2, 3, 0, 0, 0, 0, 0, 0, 0, 3, 2],
        [2, 2, 2, 2, 2, 2, 2, 2, 2, 2, 2]
      ]
    },
    {
      "level": 2,
      "stage": [
        [4, 2, 2, 0, 2, 2, 0, 2, 2, 2, 4],
        [2, 3, 0, 0, 0, 0, 0, 0, 0, 3, 2],
        [0, 0, 2, 0, 2, 0, 2, 0, 2, 0, 2],
        [2, 0, 4, 0, 0, 0, 0, 0, 4, 0, 0],
        [0, 0, 2, 0, 0, 0, 2, 0, 2, 0, 2],
        [2, 0, 0, 0, 0, 1, 0, 0, 0, 0, 2],
        [0, 0, 2, 0, 3, 0, 2, 0, 2, 0, 4],
        [2, 0, 5, 0, 0, 0, 0, 0, 6, 0, 0],
        [0, 0, 2, 0, 2, 0, 2, 0, 2, 0, 0],
        [4, 3, 0, 0, 0, 0, 0, 0, 0, 3, 0],
        [0, 2, 2, 2, 2, 2, 2, 2, 2, 2, 2]
      ]
    },
    {
      "level": 3,
      "stage": [
        [6, 2, 2, 2, 2, 2, 2, 2, 2, 2, 6],
        [2, 3, 0, 0, 0, 0, 0, 0, 0, 3, 2],
        [2, 0, 2, 7, 2, 11, 2, 7, 2, 0, 2],
        [2, 0, 4, 0, 8, 0, 0, 0, 4, 0, 2],
        [2, 0, 2, 0, 2, 0, 2, 0, 2, 0, 2],
        [2, 0, 0, 0, 0, 1, 0, 0, 0, 0, 2],
        [2, 0, 2, 0, 2, 0, 2, 0, 2, 0, 2],
        [2, 0, 5, 0, 9, 0, 8, 0, 6, 0, 2],
        [6, 0, 2, 0, 2, 0, 2, 0, 2, 0, 6],
        [6, 2, 2, 2, 2, 2, 2, 2, 2, 2, 6]
      ]
    },
    {
      "level": 4,
      "stage": [
        [10, 2, 2, 2, 4, 2, 2, 2, 2, 2, 10],
        [2, 3, 0, 0, 0, 0, 0, 0, 0, 3, 2],
        [2, 0, 2, 7, 2, 11, 2, 7, 2, 0, 2],
        [2, 0, 4, 0, 8, 0, 0, 0, 4, 0, 2],
        [2, 0, 2, 0, 2, 0, 2, 0, 2, 0, 2],
        [2, 0, 0, 0, 0, 1, 0, 0, 0, 0, 2],
        [2, 0, 2, 0, 5, 0, 9, 0, 2, 0, 2],
        [2, 0, 5, 0, 9, 0, 8, 0, 6, 0, 2],
        [10, 0, 2, 0, 2, 0, 2, 0, 2, 0, 10],
        [10, 2, 2, 2, 2, 2, 2, 2, 2, 2, 10]
      ]
    },
    {
      "level": 5,
      "stage": [
        [9, 2, 2, 2, 2, 2, 2, 2, 2, 2, 9],
        [2, 3, 0, 0, 0, 0, 0, 0, 0, 3, 2],
        [2, 0, 2, 7, 2, 11, 2, 7, 2, 0, 2],
        [2, 0, 4, 0, 8, 0, 0, 0, 4, 0, 2],
        [2, 0, 2, 0, 2, 0, 2, 0, 2, 0, 2],
        [2, 0, 0, 0, 6, 0, 10, 0, 0, 0, 2],
        [2, 0, 2, 0, 5, 0, 9, 0, 2, 0, 2],
        [2, 0, 5, 0, 9, 0, 8, 0, 6, 0, 2],
        [9, 0, 2, 0, 2, 0, 2, 0, 2, 0, 9],
        [9, 2, 2, 2, 2, 2, 2, 2, 2, 2, 9]
      ]
    }
  ]
}
